20 20            // Dimensions: 20 rows, 20 columns
0 0              // Start point at (0, 0)
19 19            // End point at (19, 19)
1 1 1 0 1 1 1 1 1 1 1 1 0 1 0 0 1 1 1 1
1 0 1 0 1 0 0 1 0 0 1 1 1 0 1 1 1 0 0 1
1 0 1 1 1 0 1 1 0 1 0 0 0 0 1 0 1 0 1 1
1 0 0 0 0 0 0 1 1 1 0 1 1 1 1 0 1 0 1 1
1 0 1 1 1 1 0 1 1 0 0 1 0 1 0 0 0 0 1 0
1 1 1 0 0 1 0 0 1 0 1 1 1 1 1 1 1 0 1 1
1 0 1 1 1 1 0 0 1 0 1 0 0 0 1 0 0 1 1 1
1 0 1 0 1 0 1 1 0 0 1 1 1 1 0 1 1 1 0 1
1 1 1 0 1 0 1 1 1 0 1 0 0 0 0 1 1 0 1 1
1 0 0 0 1 1 1 0 1 0 1 1 1 0 1 0 0 1 1 1
1 1 0 1 1 0 1 1 1 0 0 0 0 0 1 0 1 0 0 0
0 0 0 1 0 1 0 1 0 1 1 1 1 1 1 0 1 1 1 1
1 1 1 1 0 0 1 0 1 0 0 1 0 0 0 1 1 0 0 0
1 0 1 0 0 0 1 1 1 0 1 1 1 1 1 0 1 1 1 1
1 0 0 1 1 0 0 0 0 1 0 0 0 0 1 0 1 0 0 0
1 1 1 0 1 1 1 1 1 0 1 1 1 0 1 0 1 1 1 1
0 0 1 0 0 0 0 0 0 0 1 0 1 1 1 0 1 0 0 0
1 1 1 0 1 1 1 1 1 1 1 0 0 0 1 0 1 1 1 0
0 1 0 0 1 0 0 1 0 1 1 1 1 1 1 1 0 0 1 0
0 1 1 1 1 1 1 1 0 0 0 0 0 1 1 1 1 1 1 1
